102_-9_1_0.1
101_-9.5_-0.5_0.1
100_-9.25_-1.25_0.1
100_-9.25_-1.75_0.1
100_-9.25_-2.25_0.1
101_-7.5_1.5_0.1
101_-6.5_1.5_0.1
100_-5.75_1.75_0.1
100_-5.25_1.75_0.1
102_-4_1_0.1
101_-1.5_0.5_0.1
101_-0.5_0.5_0.1
101_0.5_0.5_0.1
102_2_0_0.1
100_-1.75_-0.25_0.1
100_-1.75_-0.75_0.1
100_-1.75_-1.25_0.1
100_-0.25_-0.25_0.1
100_-0.25_-0.75_0.1
101_0_-1.5_0.1
100_0.25_-2.25_0.1
101_1.5_-1.5_0.1
103_-4.875_4_0.1_0.5_4_1
101_1.5_4.5_0.1
100_2.25_4.75_0.1
100_2.75_4.75_0.1
100_1.75_3.75_0.1
101_3.5_4.5_0.1
102_5_4_0.1
101_8.5_4_0.1
102_10_3.5_0.1
102_12_3.5_0.1
102_14_3.5_0.1
102_16_3.5_0.1
101_17.5_4_0.1
201_13_5.5_0_8_6_0_18_6_0_3_5_3_1_5_1_301_7.5
102_5_-1_0.1
102_8_-1_0.1
101_6.5_-0.5_0.1
102_11_-2_0.1
102_14.5_-1.5_0.1
101_16_-1_0.1
102_17.5_-1.5_0.1
101_19_-1_0.1
102_20.5_-1.5_0.1
101_22_-1_0.1
102_23.5_-1.5_0.1
101_19.5_5_0.1
101_21_5_0.1
100_20.25_5.25_0.1
100_21.75_5.25_0.1
101_23.5_5.5_0.1
102_25_5_0.1
100_27.25_6.75_0.1
101_28_6.5_0.1
101_29_6.5_0.1
100_29.75_6.75_0.1
100_21.25_4.25_0.1
100_25.25_3.75_0.1
100_25.25_3.25_0.1
100_27.75_5.75_0.1
100_28.75_5.75_0.1
100_28.75_5.25_0.1
102_32_7_0.1
101_34_7.5_0.1
102_36_7_0.1
101_38_7.5_0.1
102_40_7_0.1
100_33.75_6.75_0.1
100_38.25_6.75_0.1
103_41.625_6_0.1_0.5_6_2
101_42_3_0.1
102_43.5_2.5_0.1
100_44.75_3.25_0.1
100_45.25_3.25_0.1
100_45.75_3.25_0.1
100_46.25_3.25_0.1
100_46.75_3.25_0.1
100_47.25_3.25_0.1
102_48.5_2.5_0.1
101_50_3_0.1
102_45.5_9.5_0.1
101_47_10_0.1
101_46_2.5_0.1
102_48.5_9.5_0.1
101_50_10_0.1
102_51.5_2.5_0.1
100_52.75_3.25_0.1
100_53.25_3.25_0.1
100_53.75_3.25_0.1
100_54.25_3.25_0.1
100_54.75_3.25_0.1
100_55.25_3.25_0.1
101_54_2.5_0.1
102_51.5_9.5_0.1
101_53_10_0.1
102_54.5_9.5_0.1
102_56.5_2.5_0.1
101_58_3_0.1
201_50_4.5_0_43.31_5_0_56.7_5_0_3_3_5_1_5_1_300_11
100_58.75_3.25_0.1
100_59.25_3.25_0.1
200_58.5_4.5_0.1_0
101_62_2.5_0.1
101_63_2.5_0.1
101_65_2.5_0.1
100_63.75_2.75_0.1
100_64.25_2.75_0.1
102_63_1_0.1
101_68_1.5_0.1
101_70_1.5_0.1
101_71.5_1.5_0.1
100_68.75_1.75_0.1
100_69.25_1.75_0.1
100_70.75_1.75_0.1
100_69.75_0.75_0.1
100_63.75_-0.25_0.1
100_63.75_-0.75_0.1
102_76_0_0.1
101_77.5_0.5_0.1
100_78.25_0.75_0.1
100_78.75_0.75_0.1
100_76.75_-1.25_0.1
100_77.25_-1.25_0.1
100_75.25_-1.25_0.1
100_77.25_-1.75_0.1
101_82.5_-0.5_0.1
102_84_-1_0.1
102_86.5_-1_0.1
102_89_-1_0.1
102_91.5_-1_0.1
102_94_-1_0.1
101_95.5_-0.5_0.1
201_89_1_0_82.31_1.5_0_95.7_1.5_0_3_5_3_1_5_2_300_301_11
101_96.5_-0.5_0.1
103_96.125_2_0.1_0.5_4_1
200_97_4_0.1_1
201_19_0.5_0_13.5_1_0_24.5_1_0_3_5_1_1_5_1_301_8
103_25.125_-2.5_0.1_0.5_4_1
103_25.125_-5.5_0.1_0.5_4_1
102_26_-8.5_0.1
102_29_-7.5_0.1
102_32_-6.5_0.1
102_35_-5.5_0.1
101_47.5_-8_0.1
100_48.25_-7.75_0.1
100_48.75_-7.75_0.1
101_49.5_-8_0.1
102_51_-8.5_0.1
101_52.5_-8_0.1
100_53.25_-7.75_0.1
100_53.75_-7.75_0.1
101_54.5_-8_0.1
100_55.25_-7.75_0.1
100_55.75_-7.75_0.1
101_56.5_-8_0.1
100_57.25_-7.75_0.1
100_57.75_-7.75_0.1
101_58.5_-8_0.1
102_60_-8.5_0.1
101_61.5_-8_0.1
100_62.25_-7.75_0.1
100_62.75_-7.75_0.1
201_54_-6.5_0_47.31_-6_0_60.7_-6_0_4_6_5_1_5_1_301_11
200_62_-6.5_0.1_0
101_65.5_-7_0.1
100_66.25_-6.75_0.1
100_66.75_-6.75_0.1
102_68_-7.5_0.1
101_69.5_-7_0.1
102_74.5_-8.5_0.1
101_76_-8_0.1
100_76.75_-7.75_0.1
100_77.25_-7.75_0.1
101_81_-8.5_0.1
102_82.5_-9_0.1
102_87_-9_0.1
102_91.5_-9_0.1
102_96_-9_0.1
101_97.5_-8.5_0.1
101_84.5_-8.5_0.1
101_94_-8.5_0.1
101_88.5_-8.5_0.1
101_90_-8.5_0.1
100_89.25_-8.25_0.1
100_85.25_-8.25_0.1
100_85.75_-8.25_0.1
100_83.75_-8.25_0.1
100_92.75_-8.25_0.1
100_93.25_-8.25_0.1
100_94.75_-8.25_0.1
103_97.875_-3.5_0.1_0.5_13_4
201_89.5_-7_0_82.81_-6.5_0_96.2_-6.5_0_4_7_5_1_5_2_300_301_11.5
105_-2.5_4.5_0.1
104_-0.75_4.75_0.1
104_0.25_4.75_0.1
200_-9_3_0.1_0
102_-11_1_0.1
102_-11_3_0.1
102_-11_5_0.1
102_99_3_0.1
102_99_5_0.1
100_97.75_5.75_0.1
101_100_1.5_0.1
100_99.75_0.75_0.1
100_100.25_0.25_0.1
100_98.25_1.75_0.1
105_38.5_-5_0.1
105_41.5_-6.5_0.1
106_45_-9_0.1
105_97.5_2.5_0.1
101_97_5.5_0.1
100_96.25_5.75_0.1
